.#.#####.#######.#.#################.###.
#.#.....#.......#.#.................#...#
#.#.#.###.###.#.#.#.#####.#####.#####.#.#
#.#.#.......#.#...#.#...#...#...#.....#.#
#.#.#########.#####.#.#.###.#####.#####.#
#...#.......#.#...#.#.#...#...#...#...#.#
#.###.#####.#.#.#.#.#.###.###.#.###.#.#.#
#.#...#...#.#...#.....#.....#...#...#.#.#
#.#.###.#.#.####.##########.#####.###.#.#
#.#.....#.#.....#.......#.#.....#...#.#.#
.########.#####.#.#####.#.#####.###.#.#.#
#.........#...#...#.#...#.....#.....#.#.#
#.#########.#.#####.#.#####.#.#######.#.#
#.#.....#...#...#...#.#...#.#.........#.#
#.#.###.#.#####.#.###.#.#.#####.#######.#
#.#...#...#...#.#...#...#.#...#.#.......#
#.###.#####.###.###.#####.#.#.###.#####.#
#.....#.....#...#...#...#...#...#...#...#
.######.###.#.###.#.#.#.#####.#.###.####.
#.....#.#...#...#.#.#0#.^...#.#...#.#...#
#.###.#.#.#####.#.#.#######.#####.#.#.#.#
#.#...#.#.....#...#.......#.......#...#.#
#.###.#.###.#.###########.#########.###.#
#...#.#.#.#.#.#.........#.#.......#...#.#
#.#.###.#.#.###.#######.#.#.###.#.###.#.#
#.#...#.#.#.....#.....#...#.#...#.#...#.#
#.###.#.#.#######.#.#########.###.#.###.#
#.#.#...#...#...#.#.#.........#.#.#...#.#
#.#.#####.#.###.#.#.#.#.#######.#.###.#.#
#.#.......#...#...#...#.....#...#.#...#.#
#.###.####.##.###.#########.#.#.#.#.###.#
#...#.....#.#...#.#.......#.#.#...#.#...#
.##.###.#.#.###.#.#.#####.#.#.#######.#.#
#@#...#.#.#.....#.#.#...#.#.#.........#.#
#.###.#.#.#.#######.###.#.#.###########.#
#.....#.#.#...#...#...#...#.#.......#...#
#.####.##.###.#.#.###.#.###.#.#####.#.##.
#.#...#...#.#...#.#...#.#.....#.....#...#
#.#.#.#.###.#####.#.###.#######.#######.#
#...#...#...........#...........#.......#
.###.###.###########.###########.#######.